SOXOXOXXX
XOXOXXXXX
XOXOXOOOX
SOXOOOXOX
XOOOOOXOX
XOXOXXXOX
XOXOXOXOX
XOXOXOXOE
